1
9550 9556 9550 9553 9558 9551 9551 9551
2
2419 2418 2423 2415 2422 2419 2420 2415
3
2419 2418 2423 2415 2422 2419 2420 2415
4
2419 2418 2423 2415 2422 2419 2420 2415
5
2419 2418 2423 2415 2422 2419 2420 2415
6
2419 2418 2423 2415 2422 2419 2420 2415
7
2419 2418 2423 2415 2422 2419 2420 2415
8
2419 2418 2423 2415 2422 2419 2420 2415
9
2419 2418 2423 2415 2422 2419 2420 2415
10
2419 2418 2423 2415 2422 2419 2420 2415